2222222222222222222222222222222222222222
2                   2                  2
2               h a 2              h a 2
2                   2                  2
2        222222222222    2    2222222222
2                        2             2
2   T                    2             2
2  T T                   2    2        2
2   T   222222222222222222    2        2
2       2                     2        2
2       2   a          T      2        2
2       2   h       2 T T     2        2
2       2           2  T   2222        2
2       2222222222222      2           2
2       2                  2           2
2       2                  2           2
2       2     T            2           2
2       2    T T    2      2   h  a    2
2       2     T     2      2           2
2       2           2      2222222222222
2       2   222222222                  2
2       2           2           T  T   2
2       2       h a 2                  2
2       2           2           T   T  2
2       2222222222222      222         2
2       2                    2         2
2       2                    2         2
2       2                    2         2
2       2                    2    S    2
2   S   2                    2         2
2       2                    2         2
22dd22222222222222222222222222222dd22222