2222222222222222222222222222222222222222
2     2                                2
2 h a 2                         h  a   2
2     2                                2
2     2          2    222222222222222222
2     2          2                     2
2     2          2          T          2
2                2                     2
2                2          T          2
2                2                     2
2     222222222222222222222222         2
2                2           2         2
2                2  h    a   2         2
2                2           2         2
2                2           2         2
22222222222      2                     2
2                2              T  T   2
2                2                     2
2                2222222222222         2
2                2           2         2
2                2  h     a  2         2
2                2           2         2
2    2222222222222           2         2
2    2                       2         2
2    2                       2         2
2    2                       2         2
2    2           2           2         2
2    2           2                     2
2    2           2                     2
2    2           2                     2
2    2           2                     2
22dd22222dd22222222222222222222222222222