2222222222222222222222222222222222222222
2                                      2
2                                      2
2                              2       2
2   22222222222222222222 a   h 2       2
2                      2       2       2
2                      222222222       2
2222222222222222222    2               2
2                 2    2               2
2                 2    2    222222222222
2       2         2    2               2
2       2         2    2               2
2       2         2    2               2
2       2         2    22222222222     2
d       2              2               2
d  S    2              2 T  T  T  T    2
d       2222222222222222               2
2       2              2 T  T  T  T    2
2       2              2               2
222222222      2       2 T  T  T  T    2
2              2       2               2
2           2222222    2   2222222222222
2           2  a                       2
2           2                          2
2           2  h                       2
2    22222222222222222222222222        2
2                      2      2        2
2                      2      2        2
2                      2      2        2
2            S         2               2
2                      2               2
222222222222ddd2222222222222222222222222