222dd22222222222222222222222222222dd2222
2       2                      2       2
2       2                      2       2
2       2                      2       2
2       2     2                2       2
2       2     2                2       2
2       2     2                2       2
2       2     2                        2
2       2     2   h   a    a           2
2       2     2                        2
2       2 T T 22222222222222222222222222
2       2     2                  2     2
2       2     2 h      T         2 h a 2
2             2       T T        2     2
2             2 a      T   2     2     2
2             2            2     2     2
2       2     22222222     2     2     2
2       2                  2           2
2       2                  2           2
2       2222222222222222222222222      2
2       2                              2
2       2                              2
2       2                              2
2       2     22222222222222222222222222
2       2                              2
2       2                              2
2       2                              2
2       22222222222222222222222222     2
2   T                                  2
2  T T                                 2
2   T                                  2
2222222222222222222222222222222222222222